1111111111111
10010000000C1
1110011111001
1P0011E001001
1111111111111