1111111111111111111111111111111111111111111111111111111111111111111111111111
1E0000000000000C00000C0000000000000000C000000C000000000000000000000000000001
1010010100100000101001000000100100010000010100000001000010100001001001000011
1010010010101010001001000010100010101010001010001010100010101010101010100011
1000000000C00C0000000000000000C00000000C000000000C000000000000000C0000000001
1010010100101010101001010010101001000101000101010010000010100101000101010011
1010010010100010100000101010100010000010101001000010100010100010100001000011
10000000000000C000000000000000000C000000000C00000000000000C00000000000000001
1010010100101010101001010010101001000101000101010010000010100101000101010011
1010010010100010100000101010100010000010101001000010100010100010100001000011
10000000000000C000000000000000000C000000000C00000000000000C00000000000000001
1010010100101010101001010010101001000101000101010010000010100101000101010011
10000000000000C000000000000000000C000000000C00000000000000C00000000000000001
1010010100101010101001010010101001000101000101010010000010100101000101010011
1010010010100010100000101010100010000010101001000010100010100010100001000011
10000000000000C000000000000000000C000000000C00000000000000C00000000000000001
1010010100101010101001010010101001000101000101010010000010100101000101010011
1010010010100010100000101010100010000010101001000010100010100010100001000011
1P000000000000C000000000000000000C000000000C00000000000000000000000000000001
1111111111111111111111111111111111111111111111111111111111111111111111111111