11111111111111111111111111111111
100000P0000000000000000000000001
10000000000000000000000000E00001
10000000000000000000000000000001
10000001111111100000000000000001
10000000000000100000000000000001
10000000000000110000000000000001
10000000000000000000000000000001
10000000000CCCCCCCC0000000000001
10000000000000000000000000000001
10000000000000000000000000000001
10000000000000000000000000000001
11111111111111111111111111111111