1111111111111111111111111111111111111111
10P000000100000000000000C001000000000001
10000000010000000000000010010000E1000001
100000000000000C000000001111000000000001
1000000001000000000000000000000000000111
1000000C0000000C000000000000000000000001
1000011100000000001111000000000000000001
1000000000000000000000000000000000000001
1000000001000000000000000000000000000001
1000000001000000000000000000000000000001
1000000001000000000000000000000000000001
1000000001000000000000000000000000000001
1000000001000000000000000000000000000001
100000000100000000000C000000000000000001
100000000100000000000CC00000000000000001
1000000001000000000000000000000000000001
1000000001000000000000000000000000000001
1000000001000000000000000000000000000001
1111111111111111111111111111111111111111